######
####.#.####
###..####.#
##........#
#......#..#
###..###..#
.....#....#
.#..##.#.##
.#......##
@#.....##
########