..##.#.####
...#.#.####
.#...###..#
###..###..#
#......#..#
###..###..#
..#..#..#.#
.##.##@#..#
.#.......#
.#.#..###
.###.###